----------------------------
----------------------------
----oo----------------------
--------E--E----------------
-------XXXXXXX-------------o
---------------------------X
-----------------oo---------
----------------------------
--XXXXX---------------------
----------------------------
----------------------XXX-?-
o---------------------------
XX--------------------------
-----------------XXXX-----XX
