----------------------------
----------------------------
----------------------------
----------------------------
----------------------------
----------------------------
----------------------------
----------------------------
----------------------------
----------------------E-----
---------------------<>-----
---------------------[]-----
-----E----EE-E-------[]-----
XXXXXXXXXXXXXXXXXXXXXXXXXXXX
