----------------------------
----------------------------
SSSSS?SSSSSSSSSSSSSSSSSSSSSS
----------------------------
----------------------------
oooooo----------------------
----------------------------
SSSSSS----------------------
SSSSSS--------------------E-
--------------------E----<>-
-------------------<>----[]-
-------------------[]----[]-
------------E-EE---[]----[]-
XXXXXXXXXXXXXXXXXXXXXXXXXXXX
