----------------------------
----------------------------
----------------------------
----------------------------
----------------------------
-SS-------------------------
----------------------------
---------o------------------
----------------------------
XXXX--SSS------------------o
XX--------------------------
----------------------------
----------------------------
--XX--XXXXXXXXXXXXXXXX--XXXX
