----------------------------
----------------------------
----------------------------
----------------------------
----------------------------
----------------------------
----------------------------
---------------------X------
--------------------XX--oo--
-------------------XXX------
------------------XXXX------
-----------------XXXXX------
E--E---------E--XXXXXX------
XXXXXXXXXXXXXXXXXXXXXXXXXXXX
