----------------------------
----------------------------
----------------------------
----------------------------
------------------------E---
--------------------SSSSSS--
----------------------------
-B--------------------------
-b-------------------E------
SXSS----------E----SSSSSSS--
-------------<>-------------
-----B-------[]-------------
-----b-------[]-------------
XXXXXXXXXX--XXXXXXXXXXXXXXXX
