----------------------------
----------------------------
----------------------------
----------------------------
----------------------------
------SSSSS-----SSSSS-------
--E------------------------E
-<>-----------------------<>
-[]-----------------------[]
-XXX----------------ES----[]
-------E------E----<>---E-[]
------<>-----<>----[]--<>-[]
------[]-----[]----[]--[]-[]
XXXXXXXXXXXXXXXXXXXXXXXXXXXX
