----------------------------
----------------------------
----------------------------
----------------------------
----------------------------
-------------------XXXX-----
-------------XXX------------
----------------------------
-----------------------XXXX-
-----EE-E-------------------
--XXXXXXXXXXXX--------------
----------------------------
----------------------------
XX-------------------------X
