----------------------------
----------------------------
----------------------------
----------------------------
----------------------------
SS------------------SSQSSS?S
----------------------------
----------------------------
-------------E--------------
------------<>------SSSSSSSS
------------[]--------------
------------[]--------------
--E-E---E---[]--------------
XXXXXXXXXXXXXXXXXXXXXXXXXXXX
