----------------------------
----------------------------
SSSSSSSSSSSSSSSSSSSSSSSSSSSS
--SSSSSS--SSSS------SSSS----
--SSSSSS--SSSS--E---SSSS----
------SS---S----SS----------
------SS---S----SS----------
------SS---S----SS----------
--ooooSS---So??-SS---E------
--SSSSSS---SSS--SS--SSSS----
-------------------EE-------
----------------------------
----E--E--------------------
XXXXXXXXXXXXXXXXXXXXXXXX---X
