----------------------------
----------------------------
----------------------------
----------------------------
----------------------------
----------------------------
----------------------------
----------------------------
-------oo-------------------
------o--o------------------
----------------------------
----------------------------
----------------------------
XXXXXXXXXXXXXXXXXXXXXXXXXXXX
