----------------------------
----------------------------
----------------------------
----------------------------
--------------------------E-
------------------------SSSS
----------------------------
-----------------------E----
--------S-------------------
-<>------------------S?S----
-[]-------------------------
-[]-------------------------
-[]-------------------------
XXXXXXXXXXXXX--XXXXXXXXXXXXX
