----------------------------
----------------------------
----------------------------
----------------------------
----------------------------
----------------------------
----------------------------
----------------------------
-------XSS-SQ---------------
------XXX------------------X
-----XXXX-----------------XX
----XXXXX----------------XXX
---XXXXXX--SSSSS--------XXXX
XXXXXXXX-------XX-XXXXXXXXXX
