----------------------------
----------------------------
----------------------------
----------------------------
----------------------------
--------------------?SS-----
----------------------------
----------------------------
----------------------------
----------------------------
-----------------E---B------
------------B--------b------
------------b--------B------
XXXXXXXXXXXXXXXXXXXXXXXXXXXX
