----------------------------
----------------------------
----------------------------
----------------------------
ooo----------E--------------
XXX----------E--E-------oo--
---------------XXXXXX-------
----------------------------
-------------------------XXX
---------XXX----------------
----------------------------
----------------------------
----------------------------
XXX-XXXXX-------------------
