----------------------------
----------------------------
----?-----------------------
----------------------------
----------------------------
----------------------XX----
------SS-------------XXX----
-----------X--------XXXX----
--SS------XX-------XXXXX----
---------XXX------XXXXXX----
--------XXXX-----XXXXXXX----
-------XXXXX----XXXXXXXX----
------XXXXXX---XXXXXXXXX----
XXXXX-XXXXXXXXXXXXXXXXXXXXXX
