----------------------------
----------------------------
----------------------------
----------------------------
----------------------------
----------------------------
----------------------------
----------------------------
--------------------oo------
----------------------------
----------------------------
-------X--------------------
---EE--X--------------------
XXXXXXXXXXXXXXXXXX------XXXX
