----------------------------
----------------------------
----------------------------
----------------------------
----------------------------
----------------------------
----------------------------
----------------------------
-E--------------------------
<>--------------------------
[]--------------------------
[]--------------------------
[]----E-E---------------E---
XXXXXXXXXXX-X-XX-XX-XX-XXXXX
