----------------------------
----------------------------
S----------SSSSSSSSSSSSSSSSS
----------------------------
---XXX----------------------
--------SSS------------E----
----------------------<>----
--------S-------------[]----
-------S-S------------[]----
Q---------S------E--SS[]SS--
----------------<>----[]----
----------------[]----[]----
----------------[]-E--[]----
X------XXXXXXXXXXXXXXXXXXXXX
