----------------------------
----------------------------
-------SSSS-----SSSSSSSSSSSS
----------------------------
--------?-------------------
-------S??------------------
------------XXX-------------
----------------------------
----------------------------
---XXX-SSSS----------------E
XX------------------E-----<>
XX-----------------<>-----[]
XX-----------------[]---E-[]
X------XXXX------XXXXXXXXXXX
