----------------------------
----------------------------
----------------------------
----------------------------
----------------------------
----------------------------
----------------------------
----------------------------
------------Q--?------------
---------Q-E------ESSS----E-
-----------E-------------<>-
-------------------------[]-
-------------------------[]-
XXXXXXXXXXXXXXXXXXXXXXXXXXXX
