----------------------------
----------------------------
----------------------------
----------------------------
----------------------------
--------------------XX------
-------------------XXX------
------------------XXXX------
-----------------XXXXX------
SSQS------------XXXXXX------
---------------XXXXXXX------
-----------<>-XXXXXXXX------
------EE---[]XXXXXXXXX------
XXXXXXXXXXXXXXXXXXXXXXXXXXXX
