----------------------------
----------------------------
----------------------------
--------------------o-------
----------------------------
------------------SSS-------
---------------------------<
---------------------------[
---------------E--------E--X
-----SSS------<>---S---<>---
--------------[]-------[]---
--------------[]-------[]---
--------------[]----E--[]---
XXXXXXXXXXXXXXXXXXXXXXXXXXXX
