----------------------------
----------------------------
----------------------------
----------------------------
----------------------------
SS--------SSS---------------
----------------------------
----------------------XX----
----------SSS--------XXX----
SSS-----------------XXXX----
-------------------XXXXX----
------------------XXXXXX----
-----------------XXXXXXX----
XXXXXXXXX----XXXXXXXXXX--XXX
