----------------------------
----------------------------
----------------------------
----------------------------
----------------------------
SS-------------SSS-----E----
----------------------<>----
----------------------[]----
----------------------[]----
SS-------E-XX--SSS----XXX---
------XX<>-XX---------------
-----XXX[]-XXX--------------
----XXXX[]-XXX--------E-----
XXXXXXX-XXXXXXXXXXXXXXXXXXXX
