----------------------------
----------------------------
----------------------------
----------------------------
---------------------Eooo---
---------------------XXXXX--
----------------------------
----------------------------
----------------------------
-------------------XXXXXXXX-
----------------------------
----------------------------
-------------XXXX----------X
XXXXXXXXXXX-----------------
