----------------------------
----------------------------
----------------------------
----------------------------
----------------------------
-S--------------------------
--------------oooo----------
----------------------------
--------------------------E-
QQQ----------------------<>-
------------X------------[]-
------------X------------[]-
------------X------------[]-
XXXXXXXXXXXXXXXXXXXXXXXXXXXX
