----------------------------
----------------------------
----------------------------
----------------------------
----------------------------
---------SSS----SQQS--------
----------------------------
----------------------------
----------------------------
Q-----S----------SS------X--
------------------------XX--
-----------------------XXX--
------------EE-E-E----XXXX--
XXXXXXXXXXXXXXXXXXXXXXXXXXXX
