----------------------------
----------------------------
----------------------------
----------------------------
----------------------------
-QQQQ-----------------------
----------------------------
----------------------------
----------------------------
Q?SSQQQ---------------------
-----------------E----------
----------------<>----------
----------------[]----------
XX--XXXXXXXXXXXXXXXXXXXXXXX-
