----------------------------
----------------------------
----------------------------
----------------------------
----------------------------
----------------------------
----------------------------
----------------E-----------
------------E--<>-----------
--------E--<>--[]-----------
-------<>--[]--[]-----------
-------[]--[]--[]-----------
-EE-E--[]--[]--[]--------EE-
XXXXXX-XX--XX--XXXXXXXXXXXXX
