----------------------------
----------------------------
----------------------------
----------------------------
----------------------------
----------------------------
----------------------------
----------------------------
--E--------E----------------
-<>------E<>-----E----------
-[]----E<>[]----<>----------
-[]---<>[][]----[]---------X
-[]---[][][]----[]--------XX
XXXXXXXXXXXXXXXXXXXXXXXXXXXX
