----------------------------
----------------------------
----------------------------
----------------------------
----E-----------------------
---SQS--SQS-----------------
----------------------------
---------------------o------
----------------------E-----
---SQS--S?S--------SSSSS----
----------------E--E-------X
-----------------------E---X
-E-----E-------------------X
XXXXXXXXXXXXXXXXXXXXXXXXXXXX
