----------------------------
----------------------------
----------------------------
----------------------------
----------------------------
------------------Q---------
----------------------------
----------------------------
----------------------------
---------------E--?---------
--------------<>------------
--------------[]------------
--------------[]------------
XXXXXXXXXXXXXXXXXXXXXXXXX--X
