----------------------------
----------------------------
-----------------------oo---
----------------------------
----------------------------
-----------------------XXX--
----------------------------
----------------------------
----------------------------
----------------XXXX------XX
----------------------------
----------------------------
----------------------------
XXXXXXXXXXX--XXXX--XXXX-----
