----------------------------
----------------------------
----------------------------
----------------------------
----------------------------
----------------------------
----------------------------
----------------------------
----------------------------
----QQQQ-------------------S
-----------B-----E---B------
-B--E------b---------b------
-b-------------------B------
XXXXXXXXXXXXXXXXXXXXXXXXXXXX
