----------------------------
----------------------------
----------------------------
----------------------------
----------------------------
----------------------------
----------------------------
----------------------------
----------------------------
----------------------------
----------------------------
----------------------------
----------E--E-EE-------EE-E
XXXXXXXXXXXXXXXXXXXXXXXXXXXX
