----------------------------
----------------------------
----------------------------
----------------------------
----------------------------
---------------SSSSS--------
----------------------------
----------------------------
----------------E-----------
---------------SSSSS--------
----------E-----------X----B
---B-----<>-----------X----b
---b-----[]-----------X----B
XXXXXXXXXXXXXXXXXXXXXXXXXXXX
