----------------------------
----------------------------
----------------------------
----------------------------
------------------oo--------
----------------------------
----------------------------
----------------------------
----E--o------E-------------
---<>--------<>-------------
---[]--------[]----------E--
---[]--------[]---------<>--
---[]--------[]-E-EE----[]-E
XXXXXXXXXXXXXXXXXXXXXXXXXXXX
