----------------------------
----------------------------
----------------------------
----------------------------
----------------------------
----------------XX----------
----------------XX----------
----------------XX----------
-------------X--XX----------
------------XX--XX----------
---E----E--XXX--XX----------
----------XXXX--------------
---------XXXXX------------X-
XXXXXXXXXXXXXXXXXXXXXXXXXXXX
