----------------------------
----------------------------
SSSSSSSSSSSSSSSSSSSSSSSSSSSS
--------------------------SS
--------------------------SS
-------------oooo-------SS--
--o---------------------SS--
-----------S-SSSS-S-----SS--
-S---------SoS--SoS-----SS--
-----------SSS--SSS-----SSSS
X--XX---------------------SS
X--XXXX-------------------SS
XE-XXXX-------EE---------E--
XXXXXXXXXXXXXXXXXXXXXXXXXXXX
