----------------------------
----------------------------
----------------------------
----------------------------
----------------------------
-SSSS-----------------------
----------------------------
----------------------------
-------------E--------------
------------<>--------------
------------[]-----------E--
------------[]----------<>--
---------E--[]--------E-[]--
X----XXXXXXXXXX---XXXXXXXXXX
