----------------------------
----------------------------
----------------------------
----------------------------
----------------------------
---oo--------------------XX-
-----------XX------------XX-
-----------------------XXXX-
-----------------------XXXX-
XXX--XXXX------------XXXXXX-
---------------------XXXXXX-
---------------------XXXXXX-
-----------------E---XXXXXX-
------------XXXXXXXXXXXXXXXX
