----------------------------
----------------------------
----------------------------
----------------------------
----------------------------
E---------------------------
>---------------------------
]-----------------------E---
XX------------E--------<>---
-------------<>---SS---[]---
---E-E-------[]--------[]---
--<><>-------[]--------[]---
--[][]-------[]--------[]---
XXXXXXXXXXXXXXXXXXXXXXXXXXXX
