----------------------------
----------------------------
----------------------------
----------------------------
----------------------------
----------------------------
----------------------------
----------------------------
----------------------------
----------------------------
--------------X-------------
--------------X-------------
--------------X-------------
--XXX--XXXXXXXX--XXXXXXXXXXX
