----------------------------
----------------------------
----------------------------
----------------------------
----------------------------
----------------------S-----
SS--------------------------
----------------------------
--------------ooo-----------
------------E---------S-----
-SSS-------<>---------------
-----------[]---------------
-----------[]---------------
XX---XXXXXXXXXXXXXXXXXXXXXXX
