----------------------------
----------------------------
----------------------------
----------------------------
----------------------------
---------------------SSSS---
----------------------------
----------------------------
-----------------X----------
--------S?S-----EX---S-----X
---------------XXX---------X
--------------XXXX---------X
-------------XXXXX----EE---X
XXXXXXXXXXXXXXXXXXXXXXXXXXXX
