----------------------------
----------------------------
----------------------------
----------------------------
----------------------------
----------------------------
----------------------------
----------------------------
-oo---oo--------------------
----------------------------
----------------------------
----------------------------
----------------E------E-EE-
----X----XXXXXXXXXXXXXXXXXXX
