----------------------------
----------------------------
----------------------------
----------------------------
----------------------------
----------------------------
------------E---------------
-----------<>---------------
-----------[]---------------
--XSSS-----XX---------------
--X----------------E--------
--X-----------B---<>-----B--
-EX-----------b---[]-----b--
XXXXXXX---XXXXXXXXXXXXXXXXXX
