----------------------------
----------------------------
----------------------------
----------------------------
----------------------------
----------------------------
----------------------------
----------------------------
-o------------E--S--------o-
-------------<>-----E-------
-------------[]----<>-------
-------------[]----[]-------
------EE-E---[]----[]-------
XXXXXXXXXXXXXXXXXXXXXXXXXXXX
