----------------------------
----------------------------
S-----SSSSSSSSSSSSSSSSSSSSSS
S-------------------SSSSSSSS
S-------------------SSSSSSSS
S-------------------SSSSSSSS
S---------------------------
S---------------------------
S---------------------------
S---------------------SSSSSS
S---------------------SSSSS-
S---------------------SSSSS-
S--------------------------o
XXXXXXXXXXX--XX--X---XXXXXXX
