----------------------------
----------------------------
----------------------------
----------------------------
----------------------------
---XXX-----oo--XXXX---------
----------XX----------------
------------------------XXX-
----------------------------
-------------XX---XXXXX-----
----------------------------
----------------------------
----------------------------
XX----XXXX-----XXXX---------
