----------------------------
----------------------------
SSSSSSSSSSSSSSSSSSSSSSSSSSSS
SSSSSSSSSSSSSSSSSSSS--------
SSSSSSSSSSSSSSSSSSSS--------
SSSSSSSSSSSSSSSSSSSS--QQ----
----------------------------
----------------------------
?-------------E-EE----------
??SSSSSSSSSSSSSSSSSS--QQ--QQ
--SSSSSSSSSSSSSSSSSS--------
--SSSSSSSSSSSSSSSSSS--------
ooSSSSSSSSSSSSSSSSSS--------
XXXXXXXXXXXXXXXXXXXXXXXXXXXX
