----------------------------
----------------------------
SSSSSSSSSSSSSSSSSSSSSSSSSS--
----------------------------
----------------------------
----------------------------
----------------------------
----------------------------
----------------------------
------------------------XXX-
----E-----SS-----------EXXX-
---<>-----SS---------EXXXXX-
-E-[]-----SS---------XXXXXX-
XXXXXXXX--XX--XXXXXXXXXXXX--
