----------------------------
----------------------------
-------------------------E--
----------------------------
----------------------------
---------------XXX----------
--------------XXXX----------
XX-----------EXXXX----------
XX----------XXXXXX----------
XX---------XXXXXXX----------
XX-------EXXXXXXXX----------
XX-------XXXXXXXXX----------
XX------XXXXXXXXXX-------XX-
XX---XXXXXXXXXXXXXXXXXXXXXXX
