----------------------------
----------------------------
----------------------------
----------------------------
----------------------------
----------------------------
----------------------------
----------------------------
---------SSSSSSSS-----------
----------------------------
----------------------------
E---------------------------
----------------------------
X-XX-XXXXXXXXXXXXXXXXX-X-X-X
