----------------------------
----------------------------
----------------------------
----------------------Q-----
----------ooooooo----------X
-------XX-------------------
--------------------XX------
-------------XX-------------
----------------------------
XXX-------------------------
----------------------------
----------------XXXXX-------
----------------------------
----XXXX--XXXX--------------
