----------------------------
----------------------------
----------------------------
----------------------------
----------------------------
----------------------------
----------------------------
----------------------------
----------------------------
----------------------------
----------------------------
----------------------------
---EE-E--E------E----------E
XXXXXXXXXXXXXXXXXXXXXXXXXXXX
