----------------------------
----------------------------
----------------------------
----------------------------
----------------------------
------------------QQQQQ-----
----------------------------
----------------------------
------------E---------------
-----------<>----E?QQQQ-----
-----------[]---------------
X----------[]---------------
X---EE-----[]-----------E-E-
XXXXXXXXXXXXXXXXXXXXXXXXXXXX
