----------------------------
----------------------------
----------------------------
----------------------------
----------------------------
------SSSS--------SSSSS-----
----------------------------
----------------------------
------------E---------------
-----S-----<>---QQQQ--QQQ---
-----------[]---------------
-----------[]---------------
-E--EE-E---[]-------E-EE----
XXXXXXXXXXXXXXXXXXXXXXXXXXXX
