----------------------------
----------------------------
----------------------------
----------------------------
----------------------------
----------------------------
----------------------------
-XSS--o---------------------
XXX-----------------------XX
XXX-SS-------------------XXX
XXX---------------------XXXX
XXX--SSS---------------XXXXX
XXX-------------------XXXXXX
XX------XXXXXXXXX---XXXXXXX-
