----------------------------
----------------------------
----------------------------
----------------------------
----------------------------
----------------------------
----------------------------
----------------------------
----------------------------
---------QQ-----------------
-------------------------XXX
----------------------XXXXXX
-------------------XXXXXXX--
XXXXXXXXXXXXX--XXXXXXXXX----
