----------------------------
----------------------------
----------------------------
----------------------------
----------------------------
-SSS------------------------
----------------------------
----------------------------
----------------------------
XXXXX-----------------------
X--------------------------X
X---------------------B----X
X-------------EE-E----b----X
XXX----XXXXXXXXXXXXXXXXXX--X
