----------------------------
----------------------------
----------------------------
----------------------------
----------------------------
----------------------------
----------------------------
----------------------------
----------------------------
------------E------E--------
-----------<>-----<>----E---
-----------[]-----[]--------
-----E-----[]-----[]--------
XXXXXXXXXXXXXXXX--XXXXXXXXXX
