----------------------------
----------------------------
SSSSSSSSSSSSSSSSSSSSSSSSSSSS
----------------------------
----------------------------
----------------------------
----------------------------
----------------------------
---S--------------------E---
-E----E----------------<>---
<>---<>-------------XX-[]--X
[]---[]------------XXX-[]--X
[]---[]--------E-E-XXX-[]--X
XXXXXXXXXXXXXXXXXXXXX--XX--X
