----------------------------
----------------------------
----------------------------
----------------------------
----------------------------
------?SSS------------------
----------------------------
------------E---------------
----E------<>---------------
---<>---E--[]---------------
---[]--<>--[]---------------
---[]--[]--[]---------------
E--[]--[]--[]---------------
XXXXXXXXXXXXXXXXXXXX---XXXXX
