----------------------------
----------------------------
----------------------------
----------------------------
----------------------------
----------------------------
--------------------------XS
-------------oo----------XXX
------------------------XXXS
oo-------XXX------------XXXX
--------XXXX----------XXXXXX
-------XXXXX---------XXXXXXX
------XXXXXX------------XXXX
XXXXXXXXXXX---XXXXXXXXXXXXXX
