----------------------------
----------------------------
----------------------------
----------------------------
ooo----------E--------------
XXX----------E--E-------oo--
---------------XXXXXX-------
----------------------------
-------------------------XX-
---------XXX----------------
----------------------------
----------------------------
----------------------------
XXX-XXXXX-------------------
