----------------------------
----------------------------
----------------------------
----------------------------
----------------------------
----------------------Q-----
----------------------------
----------------------------
----------------------------
----------------Q---S?SQS---
----------------------------
----------------------------
---------------------E------
XXXXXXXXXXXXXXXXXXXXXXXXXXXX
