----------------------------
----------------------------
----------------------------
----------------------------
-----------------------XX---
----------------------------
---------------------E------
-----------------XXXXXX-----
--------------------------XX
----------------------------
-------------XXXXX----------
----------------------------
--------------------------oo
XXXXXXXXXXX--------------XXX
