----------------------------
----------------------------
----------------------------
----------------------------
----oo--oo------------------
-------------------------E--
-----------------E----------
---------------XXXXXXXX-----
----------------------------
-----XXX-------------------X
----------------------------
---------XXXX---------------
------------------------ooo-
------------------------XXX-
