----------------------------
----------------------------
----------------------------
----------------------------
----------------------------
-Q-Q------------------------
----------------------------
----------------------------
----------------------------
-Q-Q-----------------------Q
----------------------------
----------------------------
----------------------------
XXXXXXXXXXXXXXX----XXXXXXXXX
