----------------------------
----------------------------
----------------------------
----------------------------
----------------------------
-----------------------XX---
-----------------------XX---
---------------------X-XX---
---------------------X-XX---
--E----------------X-X-XX---
-<>----------E-----X-X-XX---
-[]---------<>---X-X-X-XX---
-[]---------[]---X-X-X-XX---
XXXXXXXXXXXXXXXX-X-X-X-XXXXX
