----------------------------
----------------------------
----------------------------
----------------------------
----------------------------
-------SSSSSSSS-------------
----------------------------
----------------------------
----------------------------
------X----S----X-----------
------X------E--X-------E---
------X---------X-----------
E-EE--X---------X-----------
XXXXXXXXXXXXXXXXXXXXXX-X-XX-
