----------------------------
----------------------------
----------------------------
----------------------------
----------------------------
--S-------------------------
----------------------------
----------------------------
----------------------------
---E---------------E--------
--<>--------------<>-----E--
--[]---------B----[]----<>--
--[]---------b----[]-E--[]--
XXXXXXXXXXXXXXXXXXXXXXXXXXXX
