----------------------------
----------------------------
----------------------------
----------------------------
----------------------------
----------------------------
oooo------------oooo--------
----------------------------
--------------E-------------
-------------<>------------Q
-------------[]-------------
-------------[]-------------
-------------[]-------------
XXXXXXXXXXXXXXXXXXXXXXXXXXXX
