----------------------------
----------------------------
----------------------------
----------------------------
----------------------------
-------------------S-------S
----------------------------
----------------------------
------------------E-EE------
-------------X--------XX-XX-
-----E------XXX-------XX-XX-
----<>-----XXXX-------XX-XXX
----[]----XXXX--------X--XXX
XXXXXXXXXXXXXX--------X--XXX
