----------------------------
----------------------------
----------------------------
----------------------------
----------------------------
----------------------------
----------------------------
----------------------------
----------------------------
------------------<>--------
----------<>------[]--------
<>--------[]------[]--------
[]--------[]-E----[]-----E-E
XXXXXXXXXXXXXXXXXXXXXXXXXXXX
