----------------------------
----------------------------
----------------------------
-----------------o----------
----------------XXX---------
--------------------o------o
XXX--o---o---o------XXXX----
----XXX-XXX-XXX-------------
---------------------------X
----------------------------
----------------------------
-----------------------XXXX-
-----------E----------------
----XXXXXXXXXXXXXXXX--------
