----------------------------
----------------------------
----------------------------
----------------------------
----------------------------
----------------------------
----------------------------
----------------------------
-XXXX------oooo-------------
------------------XXXXXX----
XX--------------------------
----------------------------
----------------------------
----XXXXXXXXX-XXXX------XXXX
