----------------------------
----------------------------
------------------------ooo-
------------------------XXXX
XX--------------------------
----------XXoo----XX--------
----------------------------
----------------------------
----------------------------
----XXXXXX----XX-----XX-----
------------------------XXXX
----------------------------
----------------------------
----------------------------
