----------------------------
----------------------------
----------------------------
----------------------------
----------------------------
----------------------------
----------------------------
----------------------------
----------------------------
-----------------------E----
-----------------------E----
----------------------------
---EEE------EE-E------------
XXXXXXXXXXXXXXXXXXXXXXXXXXXX
