----------------------------
----------------------------
S-----SSSSSSSSSSSSSSSSSSSSSS
S---------------------------
S---------------------------
S---------------------------
S---------------------------
S---------------------------
S---------------------------
S---------QQQQQ--------XXXX-
S--------------------XXXXXXX
S------------------XXXXXXXXX
S-------------EE-XXXXXXXXXXX
XXXXXXXXXXXXXXXXXXXXXXXXXXXX
