----------------------------
----------------------------
----------------------------
----------------------------
----------------------------
--SSSSSSSSS------------SS---
----------------------------
----------------------------
---------------------SS-----
---------------------------S
---------------E---E--------
--------------<>--<>--------
--------------[]--[]--------
XXXXXX------XXXXXXXXXXXX-X-X
