----------------------------
----------------------------
----------------------------
----------------------------
----------------------------
-----------------------E--S-
----------------------<>----
----------------------[]----
--------------E-------[]----
------E------<>------SXXS---
-----<>------[]--E---------E
-----[]------[]-<>--------<>
-----[]------[]-[]--------[]
XXXXXXXXXXXXXXXXXXXXXXXXXXXX
