----------------------------
----------------XXX---------
SSSSSSSSSSSSSSS-----SSSSSSSS
--------------------SSSSSSSS
--------------------SSSSSSSS
--------------------SSSSSSSS
--------------------S-------
--------------------S-------
---E-----------------?oooooo
--<>-----------------??SSSSS
--[]----------XX------------
--[]---------XXXXXX---------
--[]--------XXXX------------
XXXX--XXXXXXXXX-----XXXXXXXX
