----------------------------
----------------------------
----------------------------
----------------------------
----------------------------
----------------------------
----------------------------
----------------------------
----o----o------------------
----------------------------
----------------------------
----------------X---X-------
----------------X-E-X-------
XXX---XX---XXXXXXXXXXXXXXXX-
