----------------------------
----------------------------
----------------------------
----------------------------
----------------------------
----------------------------
----------------------------
----------------------------
----------------------------
----------------------------
----------------------------
----------------------------
--------------E-EE-------E--
XXXXXXXXXXXXXXXXXXXXXXXXXXXX
