----------------------------
----------------------------
----------------------------
----------------------------
----------------------------
----------------------------
----------------------------
----------------------------
----E-----------------------
---<>------------------E--S-
---[]-----------------<>----
---[]-----------------[]----
--E[]-----------EE-E--[]-E--
XXXXXXXXXX---XXXXXXXXXXXXXXX
