----------------------------
----------------------------
----------------------------
----------------------------
----------------------------
-----------------SSSSS---?--
----------------------------
----------------------------
----------------------------
--------------S---E---------
-------X---------------E----
---E---X--------------------
-------X-----EE-------------
XXXXX--XXXXXXXXXXXXXXXXXXXXX
