----------------------------
----------------------------
----------------------------
----------------------------
----------------------------
SSSS---SSSQ--------------?--
----------------------------
----------------------------
----------------------------
----------S-----SS----Q--Q--
----------------------------
----------------------------
-----------E-E--------E-----
XX---XXXXXXXXXXXXXXXXXXXXXXX
