----------------------------
----------------------------
----------------------------
----------------------------
----------------oo----------
-o----XXX------XXXX---------
--------------------o----E--
-------------------XXX------
XXX-------------------------
----XXX-XXX-----------------
-------------------o--------
------------XXX---XXXXX-----
----------------------------
---------------------------X
