----------------------------
----------------------------
-----------------------oo---
----------------?-----XXXX--
----------------------------
----------------------------
----o----ooo------E--------X
--------------XXXXXX--------
X---------------------------
----------XXXX-----ooo------
---------------------E------
-------------XXXXXXXXXX-----
---XXXXXXX------------------
----------------------------
