----------------------------
----------------------------
----------------------------
----------------------------
----------------------------
----------------------------
----------------------------
----------------------------
----------------------------
X----------XX--X------------
XX--------XXX--XX-----------
XXX------XXXX--XXX-----<>---
XXXX----XXXXX--XXXX----[]---
XXXXXXXXXXXXX--XXXXXXXXXXXXX
