----------------------------
----------------------------
----------------------------
----------------------------
----------------------------
----------------------------
----------------------------
----------------------------
----------------------------
-QS--------------<>-----X---
-----------------[]----XX---
-----------------[]---XXX---
-------------E---[]-EX-XX---
XXXXXXXXX--XXXXXXXXXXXXXXXXX