----------------------------
----------------------------
----------------------------
----------------------------
----------------------------
----------------------------
----------------------------
----------------------------
----------------------------
--------------SS------S----S
----------------------------
----------------------------
---------EE-E-------------EE
XXXXXXXXXXXXXXXXXXXXXXXXXXXX