----------------------------
----------------------------
----------------------------
----------------------------
----------------------------
--------------------?SQSSSSS
----------------------------
----------------------------
----------------------------
--------------<>----S------S
--------------[]------------
--------------[]------------
----------E-E-[]--------E-E-
XXXXXXXXXXXXXXXXXXXXXXXXXXXX