----------------------------
----------------------------
----------------------------
----------------------------
----------------------------
SSS--SSSS-------------------
----------------------------
----------------------------
----------------------------
-------------------S-S------
----------------------------
-------------------------<>-
-------------------------[]-
XXXXXXXXXXXXXXXXXXXXXXXXXXXX