----------------------------
----------------------------
----------------------------
----------------------------
----------------------------
--------------------?SSSSSSS
----------------------------
----------------------------
----------------------------
--------------S?----SS----?S
----------------------------
----------------------------
---------E-E---E----------E-
XXXXXXXXXXXXXXXXXXXXXXXXXXXX