----------------------------
----------------------------
----------------------------
----------------------------
----------------------------
S---------------------------
----------------------------
----------------------------
----------------------------
-----------Q--------------XX
--------------------------XX
--------------------------XX
--------------------------XX
XXXXXX----XXX--XXXXXXX--XXXX