----------------------------
----------------------------
----------------------------
----------------------------
----------------------------
S---------------------------
----------------------------
----------------------------
----------------------------
------------Q-------XXX---XX
------------------X-XXX---XX
-----------------XXXXXX--XXX
----------------XXXXX-X--XXX
X-XX-------------XXXXX---XXX