----------------------------
----------------------------
----------------------------
----------------------------
----------------------------
SSSSSSSSSQ------------------
----------------------------
----------------------------
----------------------------
-------------------XXXX---X-
-----------------XXXXX---XX-
----------------XXXXXX---XXX
---------------XXXXXX----[]-
XXXXXX---------XXXXXXXXXXXXX