----------------------------
----------------------------
----------------------------
----------------------------
----------------------------
------------------------SSSS
----------------------------
----------------------------
----------------------------
--------------S------S-----S
----------------------------
----------------------------
---------E-E---E----------EE
XXXXXXX--XXXXXXXXXXXXXXXXXXX