----------------------------
----------------------------
----------------------------
----------------------------
----------------------------
SS---SSS--------------------
----------------------------
----------------------------
----------------------------
-------------------XXXX--XXX
-------------------XXXX--XXX
----------------XXXXXXX--XXX
---------------XXXXXX-X--XXX
XXXX-----------XXXXXXXXXXXXX