----------------------------
----------------------------
----------------------------
----------------------------
----------------------------
S-----SS--------------------
----------------------------
----------------------------
----------------------------
----SS-----------------X----
--------------->-------XX---
--------------<>-------XX---
---------E----[]--E---XXX---
XXXXXXXXXXXXXXXXXXXXXXXXXXXX