----------------------------
----------------------------
----------------------------
----------------------------
----------------------------
----------------------------
----------------------------
----------------------------
----------------------------
--------------------------X-
--------------------------X-
-------------------------<XX
---------E--------E------[]X
XXXXXXXXXXXXXXXXXXXXXXXXXXXX