----------------------------
----------------------------
----------------------------
----------------------------
----------------------------
---------------------SSS----
----------------------------
----------------------------
----------------------------
-----------------------XX---
-----------------------X----
----------------->--XXXXXXX-
-----------------[--XXXXXXXX
XXXXXXXXXXXXXXXXXXXXXXXXXXXX