----------------------------
----------------------------
----------------------------
----------------------------
----------------------------
---------------------SSSSSSS
----------------------------
----------------------------
----------------------------
--------------<>---SSS-----S
--------------[]------------
--------------[]------------
---------EE-E-[]----------E-
XXXXXXXXXXXXXXXXXXXXXXXXXXXX