----------------------------
----------------------------
----------------------------
----------------------------
----------------------------
-SSSSSSSSQ------------------
----------------------------
----------------------------
----------------------------
---------------<-----QS-----
---------------[]-----------
---------------[]-----------
---------E-----[]---------E-
XXXXXXXXXXXXXXXXXXXXXXXXXXXX