----------------------------
----------------------------
----------------------------
----------------------------
----------------------------
-S--------------------------
----------------------------
----------------------------
----------------------------
------------Q------XXXX--X--
------------------XXXXX--X-X
-----------------XXXXXXXXXXX
----------E----XXXXXXXXXXXXX
XXXXX----XX----XXXXXXXXXXXXX