----------------------------
----------------------------
----------------------------
----------------------------
----------------------------
-----------------SS---------
----------------------------
----------------------------
----------------------------
----------------------XXXX--
--------------------XXXX---X
--------------------XXXXX-X-
------------------XXXXXXXXXX
XXXXXXXXXXXXXXXXXXXXXXXXXXXX