----------------------------
----------------------------
----------------------------
----------------------------
----------------------------
----------------------SS----
----------------------------
----------------------------
----------------------------
------------------X----XX---
-----------------[----XXX---
-----------------[]-XXXXXX--
-------------E---[]XXXXXXX-S
XXXXXXXX---XXXXXXXXXXXXXXXXX