----------------------------
----------------------------
----------------------------
----------------------------
--------X-------------------
-SSSSSSSSQS-----------------
----------------------------
----------------------------
----------------------------
----------------------X-----
-----------------XX--XX--X--
-----------------XXXXX--XXX-
----------E----XXXXXXXX-XXXX
XXXXXXXXX---XXXXXXXXXXXXXXXX