----------------------------
----------------------------
----------------------------
----------------------------
----------------------------
----------------------------
----------------------------
----------------------------
----------------------------
-QS------S-----------XX-X-XX
-----------------X--XXX--XXX
----------------<XXXXXX--XXX
----------------X]XXXXX--XXX
XXX---XXX--XXXXXXXXXXXXXXXXX