----------------------------
----------------------------
----------------------------
----------------------------
----------------------------
----------------------------
----------------------------
----------------------------
----------------------------
------------Q------X--XXX---
------------------XXX-XX----
-----------------XXXXXXXXXX-
----------E------XXXXXXXXXX-
XXXXXX-XXXXQ----XXXXXXXXXXXX