----------------------------
----------------------------
----------------------------
----------------------------
----------------------------
----------------------------
----------------------------
----------------------------
----------------------------
-------------------X-XX-XX--
------------------XXXXX--X-X
-----------------XXXXXXXXXX-
----------------XXXXXXXXXXXX
XXXXXX---XX-----XXXXXXXXXXXX