----------------------------
----------------------------
----------------------------
----------------------------
----------------------------
S----------------------Q----
----------------------------
----------------------------
----------------------------
-----------Q-------X-XX-----
------------------XX--XX--XX
-----------------XXXXXXX--XX
-----------------XXXX-XXXXXX
XXXXXX----X-----XXXXXXXXXXXX