----------------------------
----------------------------
----------------------------
----------------------------
----------------------------
---SSSS--Q------------------
----------------------------
----------------------------
----------------------------
-QS------S---------X--X---X-
-----------------XXX--X---X-
----------------XXXX--X--XXX
---------------XXXXX--XX-XXX
XXX------------XXXXXXXXXXXXX