----------------------------
----------------------------
----------------------------
----------------------------
----------------------------
--SSSSQ-------------------SS
----------------------------
----------------------------
----------------------------
-------------------S-S------
--------------->------------
--------------[]------------
---------EE-E-[]----------E-
XXXXXXXXXXXXXXXXXXXXXXXXXXXX