----------------------------
----------------------------
----------------------------
----------------------------
----------------------------
------------------SQ-----SS-
----------------------------
----------------------------
----------------------------
-----------Q--Q------S------
----------------------------
----------------------------
----------------------------
XXXXXXX--XXXXXXXXXXXXXXXXXXX