----------------------------
----------------------------
----------------------------
----------------------------
----------------------------
---------------------SSSSSSS
----------------------------
----------------------------
----------------------------
--------------<-----S-------
---------------]------------
--------------[]------------
---------E----[]--------E---
XXXXXXXXXXXXXXXXXXXXXXXXXXXX