----------------------------
----------------------------
----------------------------
----------------------------
----------------------------
SS----SS--------------------
----------------------------
----------------------------
----------------------------
--------------------XXX---XX
-----------------XXXXXX--XXX
----------------XXXXXXX--XXX
---------------XXXXXX-X--XXX
XXXXXX----------XXXXXXX-XXXX