----------------------------
----------------------------
-------XX-------------------
-------XXX------------------
-------XX-------------------
------SXXXXX----------------
----------------------------
----------------------------
----------------------------
-Q---------------<>---------
-----------------[]--------X
-----------------[]--X----XX
-------------E-E-[]-EX---EXX
XXXX-XXXX---XXXXXXXXXXX-XXXX