----------------------------
----------------------------
----------------------------
----------------------------
----------------------------
----------------------------
----------------------------
----------------------------
----------------------------
-QS--------------<>----XX---
-----------------[]---X----X
-----------------[]--XX-X-XX
------E------E---[]-XXX-XXXX
XXX---XXX--XXXXXXXXXXXXXXXXX