----------------------------
----------------------------
----------------------------
----------------------------
----------------------------
S---------------------------
----------------------------
----------------------------
----------------------------
---------------------XXXXX--
------------------XXXXX--X-X
-----------------XXXXXXXXXXX
-----------------XXXXXXXXXXX
XXXXXX--XXX------XXXXXXXXXXX