----------------------------
----------------------------
----------------------------
----------------------------
----------------------------
---SSS----------------------
----------------------------
--E-------------------------
----------------------------
-QS------S?-----------X?----
------------------X---XX----
-----------------XX---XX----
------E---E----X-XXX--XXX---
XXXX-XXXX---XXXXXXXXXXXXXXXX