----------------------------
----------------------------
----------------------------
----------------------------
----------------------------
---------------------SSSSSSS
----------------------------
----------------------------
----------------------------
----------------------------
----------------------------
----------------------------
---------------E--------E---
XXXXXXX----XXXXXXXXXXXXXXXXX