----------------------------
----------------------------
----------------------------
----------------------------
----------------------------
----------------------SS----
----------------------------
----------------------------
----------------------------
--Q--------------XXX---XX---
-----------------XX---XXX---
-----------------XX---XXX---
-----------------[XXXXXXXX--
XXXXXXXXX--XXXXXXXXXXXXXXXXX