----------------------------
----------------------------
----------------------------
----------------------------
----------------------------
---SS---------------?SQ-----
----------------------------
----------------------------
----------------------------
-?S-----Q-----S--<>-S-S-S--S
-----------------[]---------
-----------------[]---------
------E-E--E-E-E-[]-----E---
XXXXXXXXXXXXXXXXXXXXXXXXXXXX