----------------------------
----------------------------
----------------------------
----------------------------
----------------------------
----------------------------
----------------------------
----------------------------
----------------------------
---------S------------S---XX
--------------------------XX
X>---------------X--------XX
[----------------[]------XXX
XXXX--XXXX-XXXXXXXXXXX---XXX