----------------------------
----------------------------
----------------------------
----------------------------
----------------------------
-----------------S-----S----
----------------------------
----------------------------
----------------------------
-----------------------XX---
----------------------XXX---
-----------------X--XXXXXX--
-----------------[XXXXXXXX--
XXXXXXXXXXXXXXXXXXXXXXXXXXXX