----------------------------
----------------------------
----------------------------
----------------------------
----------------------------
----------------------------
----------------------------
----------------------------
----------------------------
---------------------XX--XXX
--------------------XXX--XXX
------------------XXXXX--XXX
------------------XXXXX--XXX
XXXXXXXXXXXX-----XXXXXX-XXXX