----------------------------
----------------------------
----------------------------
----------------------------
----------------------------
----------------SSSSSSQ-----
----------------------------
----------------------------
----------------------------
--------------S--<>----XS---
-----------------[]---------
-----------------[]--XX---XX
------E------E-E-[]-EX-----E
XXX---XXX--XXXXXXXXXXXXXXXXX