----------------------------
----------------------------
----------------------------
----------------------------
----------------------------
----------------------------
----------------------------
----------------------------
----------------------------
------------Q------X-XX-XX--
------------------XXXXX--X-X
---------------<>XXXXXXXXXX-
----------E----[XXXXXXXXXXXX
XXXXX----XX---XXXXXXXXXXXXXX