----------------------------
----------------------------
----------------------------
----------------------------
----------------------------
--------------------?SSSSSSS
----------------------------
----------------------------
----------------------------
-Q------------S-----S------S
----------------------------
----------------------------
---------------E------------
XXXXXXXX---XXXXXXXXXXXXXXXXX