----------------------------
----------------------------
----------------------------
----------------------------
----------------------------
----------------------SSSSSS
----------------------------
----------------------------
----------------------------
----S--Q------<----S?S------
----------------------------
--------------<]------------
--------------[]------------
XXXXXXXXXXXXXXXXXXXXXXXXXXXX