----------------------------
----------------------------
----------------------------
----------------------------
----------------------------
---------------------SSSSSSS
----------------------------
----------------------------
----------------------------
-?S------S------------------
-----------------[----------
----------------------------
------E-E----E-E-[----------
XXXXXXXXX--XXXXXXXXXXXXXXXXX