----------------------------
----------------------------
----------------------------
----------------------------
----------------------------
----------------------------
----------------------------
----------------------------
----------------------------
-QS------S------------X---XX
-----------------XX--X----XX
-----------------X]--XX---XX
------E---------X]XXX-X--XXX
XXXX--XXX---XXXXXXXXXXX-XXXX