----------------------------
----------------------------
----------------------------
----------------------------
----------------------------
----SSSS--------------------
----------------------------
----------------------------
----------------------------
---------------<>----S------
---------------[]-----------
---------------[]-----------
------------E--[]--------[E-
XXXXXXXXXXXXXXXXXXXXXXXXXXXX