----------------------------
----------------------------
----------------------------
----------------------------
----------------------------
----------------------------
----------------------------
----------------------------
----------------------------
-QS--------------<>----XS---
-----------------[]----X----
-----------------[]---XX----
------E-E----E---[]--X-XX---
XXXXXXXXXXXXXXXXXXXXXXXXXXXX