----------------------------
----------------------------
----------------------------
----------------------------
----------------------------
---SS-----------------SSSSSS
----------------------------
--E-------------------------
----------------------------
-QS-------------------------
----------------------------
-----------------XX---------
------E--------E-[]---------
XXX------------XXXXXXXXXXXXX