----------------------------
----------------------------
----------------------------
----------------------------
----------------------------
---------------------SSSSSSS
----------------------------
----------------------------
----------------------------
--------------S>---SS-------
----------------------------
--------------<-------------
--------------[]------------
XXXXXXXXXXXXXXXXXXXXXXXXXXXX