----------------------------
----------------------------
----------------------------
----------------------------
----------------------------
----------------------SSS---
----------------------------
----------------------------
----------------------------
------------------XX--------
-----------------XX---------
-----------------XX---------
---------------XXXXX--------
XXXXXXXXXX----XXXXXXXXXXXXXX