----------------------------
----------------------------
----------------------------
----------------------------
----------------------------
---------------------SQ-----
----------------------------
----------------------------
----------------------------
-QS------S-------<>----XS---
-----------------[]----X----
-----------------[]---XX----
------E------E-E-[]--X-XX--E
XXX--XXXX--XXXXXXXXXXXXXXXXX