----------------------------
----------------------------
----------------------------
----------------------------
----------------------------
---------------------SSSSSSS
----------------------------
----------------------------
----------------------------
-?S--Q--QS----SS----S-------
----------------------------
X]--------------------------
[]---E----------------------
XXXXXXXXXXXXXXXXXXXXXXXXXXXX