----------------------------
----------------------------
----------------------------
----------------------------
----------------------------
----------------------------
----------------------------
----------------------------
----------------------------
--S-----Q------------X--X--X
----------------->---X---XXX
----------------<>--XX--XXXX
----------------[]--XX---XXX
XXXXXXXXXXXXXXXXXXXXXXXXXXXX