----------------------------
----------------------------
----------------------------
----------------------------
----------------------------
---SSQ---QS----------S------
----------------------------
--E-------------------------
----------------------------
-?S------S-------<>---XXS---
-----------------[]----XX---
-----------------[]---XXX---
------E---E--E-E-[]--XXXX---
XXXX-XXXX--XXXXXXXXXXXXXXXXX