----------------------------
----------------------------
----------------------------
----------------------------
----------------------------
---SSS----------------------
----------------------------
----------------------------
----------------------------
-QS------S?-Q------X-XXX----
------------------XX--XX----
-----------------XXXXXXX--X-
----------E----XXXXXX-XXX---
XXX---XXX------XXXXXXXXXXXXX