----------------------------
----------------------------
----------------------------
----------------------------
----------------------------
----------------------------
----------------------------
----------------------------
----------------------------
-----QS-Q------<------------
->-------------[]------XX---
<>-------------[]-----XXX-X-
[]-E-E---------[]-E---XXXXXX
XXXXXXXXXXXXXXXXXXXXXXXXXXXX