----------------------------
----------------------------
----------------------------
----------------------------
----------------------------
----S-----------------------
----------------------------
----------------------------
----------------------------
-QS------SQ----------XX-X--X
--------------------XXX--XXX
----------------<>-XXXXXXXXX
----------------[]-XXXXX-XXX
XXXX--XXXX-XXXXXXXXXXXXXXXXX