----------------------------
----------------------------
----------------------------
----------------------------
----------------------------
------------------------SSSS
----------------------------
----------------------------
----------------------------
----S--------------S?S-----S
----------------------------
--------------[]------------
---------EE-E-[]------------
XXXXXXXXXXXXXXXXXXXXXXXXXXXX