----------------------------
----------------------------
----------------------------
----------------------------
---------------------------E
--------------------?SSSSSSS
----------------------------
----------------------------
----------------------------
--------------SS---SSS-----S
----------------------------
----------------------------
--------------------------E-
XXXXXXXXXXXXXXXXXXXXXXXXXXXX