----------------------------
----------------------------
----------------------------
----------------------------
----------------------------
-----------------SSS--------
----------------------------
----------------------------
----------------------------
--------------SS--------X---
----------------------------
---------------------X------
---------------------XX--XXE
XXXXXXXXXXXXXXXXXXXXXXXXXXXX