----------------------------
----------------------------
----------------------------
----------------------------
----------------------------
---------------------SSS----
----------------------------
----------------------------
----------------------------
-QS------SQ------XXX--XXX---
-----------------XX---XX---X
-----------------XX-XXXXX-XX
------E--------E-[XXXXXXXXXX
XXXX-XXXX---XXXXXXXXXXXXXXXX