----------------------------
----------------------------
----------------------------
----------------------------
----------------------------
SSSSSSSS--------------------
----------------------------
----------------------------
----------------------------
------------Q------X-X---X--
-----------------XXXXX---X--
----------------XXXXXX-XXXX-
----------E----XXXXXX-XXXXX-
XXXXX----XX--XXXXXXXXXXXXXXX