----------------------------
----------------------------
----------------------------
----------------------------
----------------------------
----------------------------
----------------------------
----------------------------
----------------------------
-QS--------------<----XXX---
-----------------[---XX----X
-----------------[]--XX---XX
------E------E---[]-XXX--XXX
XXXX-XXXX--XXXXXXXXXXXXXXXXX