----------------------------
----------------------------
----------------------------
----------------------------
----------------------------
----------------------------
----------------------------
----------------------------
----------------------------
--------------------XXX--XXX
-------------------XXXX--XXX
----------------XXXXXX---XXX
----------------XXXXX-X--XXX
XXX------------XXXXXXXXXXXXX