----------------------------
----------------------------
-------XX-------------------
-------XXXX-----------------
------XXXX------------------
------XXXXXXX---SSS---SS----
----------------------------
----------------------------
----------------------------
-----------------<>---------
-----------------[]---------
-----------------[]-------XX
------E------E-E-[]-X----EXX
XXX--XXX----XXXXXXXXXXX-XXXX