----------------------------
----------------------------
----------------------------
----------------------------
----------------------------
-SSSSSSSS-------------------
----------------------------
----------------------------
----------------------------
------------Q------XXXX--X--
-------------------XXX--XXX-
---------------->XXXXX-XXXX-
----------E----[XXXXX-XXXXX-
XXXXX---XXX---XXXXXXXXXXXXXX