----------------------------
----------------------------
----------------------------
----------------------------
----------------------------
--------------------?SQS---S
----------------------------
----------------------------
----------------------------
-?S--Q--Q-----S--<>-S-------
-----------------[]---------
-----------------[]---------
[E-E-E-----E-----[]-----E---
XXXXXXXXXXXXXXXXXXXXXXXXXXXX