----------------------------
----------------------------
----------------------------
----------------------------
----------------------------
----------------------------
----------------------------
----------------------------
----------------------------
-------------------SQS------
----------------------------
--------------[>------------
---------EE---[]------------
XXXXXXXXXXXXXXXXXXXXXXXXXXXX