----------------------------
----------------------------
--------XX------------------
-------XXX------------------
-------XXX------------------
-------XXXX-----------SSSSSS
----------------------------
----------------------------
----------------------------
-Q---------------<----------
-----------------[----------
-----------------[]---------
-------------E-E-[]--------E
XXX-XX------XXXXXXXXXXXXXXXX