----------------------------
----------------------------
----------------------------
----------------------------
----------------------------
----------------------------
----------------------------
----------------------------
----------------------------
---------------------XX--XXX
--------------------XXX--XXX
-------------------XXXX--XXX
------------------XXXXX--XXX
XXXXXX-XXXXX---XXXXXXXX--XXX