----------------------------
----------------------------
----------------------------
----------------------------
----------------------------
----------------------------
----------------------------
----------------------------
----------------------------
------------Q-------XXX--XXX
-------------------XXXX--XXX
---------------->-XXXXX--XXX
----------------XXXXXXX--XXX
XXXXXX-XXXXX----XXXXXXXXXXXX