----------------------------
----------------------------
----------------------------
----------------------------
----------------------------
---?S---------------?SQS----
----------------------------
----------------------------
----------------------------
-----Q--------S>-------XX---
---------------]-------XX---
----------------------XXX---
-----E----E-E-[]-----X-XX---
XXXXXXXXXXXXXXXXXXXXXXXXXXXX