----------------------------
----------------------------
----------------------------
----------------------------
----------------------------
---SS-----------------------
----------------------------
----------------------------
----------------------------
-?S-----Q--------<>-----X---
-----------------[]----XX---
-----------------[]----XX---
------E-E--E-----[]--X-XXX--
XXXXXXXXX--XXXXXXXXXXXXXXXXX