----------------------------
----------------------------
----------------------------
----------------------------
----------------------------
---------------------SQS----
----------------------------
----------------------------
----------------------------
-----Q--QS----S--<>---------
-----------------[]---------
X>---------------[]---------
[X-----------E-E-[]-----E--E
XXXXXXXXXXXXXXXXXXXXXXXXXXXX