----------------------------
----------------------------
----------------------------
----------------------------
----------------------------
-----------------SSS?SSS-Q-S
----------------------------
----------------------------
----------------------------
-Q------------SS----S---S---
----------------------------
----------------------------
-----------E-E-E-------EE---
XXXXXXXXXXXXXXXXXXXXXXXXXXXX