----------------------------
----------------------------
----------------------------
----------------------------
-----------------------E----
---------------------SSSSSXS
----------------------------
--------------------E-------
----------------------------
----------------------------
----------------------------
--------------<>------------
----------E---[]--------E---
XXXXXXXXXXXXXXXXXXXXXXXXXXXX