----------------------------
----------------------------
----------------------------
----------------------------
----------------------------
----------------S-S---SSSS--
----------------------------
----------------------------
----------------------------
-----------Q--Q------S------
----------------------------
----------------------------
----------------------------
XXXXXX----XXXXXXXXXXXXXXXXXX