----------------------------
----------------------------
----------------------------
----------------------------
----------------------------
-----------------SSS?S------
----------------------------
----------------------------
----------------------------
--------------SS------XXX---
----------------------XX----
X>--------------------XX----
[XX------------E-----XXXX--E
XXXXXXXXXXXXXXXXXXXXXXXXXXXX