----------------------------
----------------------------
----------------------------
----------------------------
----------------------------
-SSSSSSSSQ------------SSSS-S
----------------------------
----------------------------
----------------------------
-QS-------------------------
----------------------------
-----------------------X----
--------E--------------XX---
XXXXXXXX-XXXXXXXXXXXXXXXXXXX