----------------------------
----------------------------
--------X-------------------
-------XXX------------------
-------XXX------------------
----S--XXXXX----------------
----------------------------
----------------------------
----------------------------
-QS--------------<>---------
-----------------[]---------
-----------------[]---------
------E--------E-[]--------X
XX-----X-------X-XX-X----XXX