----------------------------
----------------------------
----------------------------
----------------------------
----------------------------
----------------SSSS--------
----------------------------
----------------------------
----------------------------
-------------SS--------XX---
----------------------XX----
---------------------XXXX---
--------------------XXXXXX-E
XXXXXXXXXXXXXXXXXXXXXXXXXXXX