----------------------------
----------------------------
----------------------------
----------------------------
----------------------------
---?SSQ---------------------
----------------------------
----------------------------
----------------------------
-----Q------Q--<>-----------
---------------[]--------XX-
---------------[]--------XXX
----------E-E--[]--------X]X
XXXXXXXXXXXXXXXXXXXXXXXXXXXX