----------------------------
----------------------------
----------------------------
----------------------------
----------------------------
--------------------?SQS----
----------------------------
----------------------------
----------------------------
-?S--S--Q-----S-->------X---
-----------------[-----XX---
-----------------[-----XX---
-----------E-----]---E-XX---
XXXXXXXXXXXXXXXXXXXXXXXXXXXX