----------------------------
----------------------------
----------------------------
----------------------------
----------------------------
----------------------------
----------------------------
----------------------------
----------------------------
--------------S-------------
----------------------------
---------------------------X
---------------------------X
XXXXXX----XXXXXXXXXXX---XXXX