----------------------------
----------------------------
----------------------------
----------------------------
----------------------------
SSSSSSSSS-------------------
----------------------------
----------------------------
----------------------------
--Q----------------X--X-----
------------------XXX-------
-----------------XXX---X----
----------------XXXX--XXXX--
XXXXXXX--XXXXXXXXXXXXXXXXXXX