----------------------------
----------------------------
----------------------------
----------------------------
----------------------------
---SSSQ---------------------
----------------------------
----------------------------
----------------------------
-----Q---------<>-----------
---------------[]--------X>-
---------------[]--------<>-
---------EE-E--[]--------[]-
XXXXXXXXXXXXXXXXXXXXXXXXXXXX