----------------------------
----------------------------
----------------------------
----------------------------
----------------------------
----------------------------
----------------------------
----------------------------
----------------------------
-----------------Q-----XX--X
---------------------XX----X
-----------------X--XX--X-XX
-----------------]--XX---XXX
XXXXXXXXXXXXXXXXXXXXXXXXXXXX