----------------------------
----------------------------
--------X-------------------
-------XXX------------------
-------XX-------------------
------QXXXXX----------------
----------------------------
----------------------------
----------------------------
-QS--------Q-----<----------
-----------------X]---------
-----------------[]---------
------E-E--------[]-E-------
XXXXXXXX----XXXXXXXXXXXXXXXX