----------------------------
----------------------------
----------------------------
----------------------------
----------------------------
---------------------------S
----------------------------
----------------------------
----------------------------
----SS--Q------>-------?S---
---------------]-------X----
--------------[]-------X----
-E-E-E--------[]-------XX---
XXXXXXXXXXXXXXXXXXXXXXXXXXXX