----------------------------
----------------------------
----------------------------
----------------------------
----------------------------
--------------------?SSSSSSS
----------------------------
----------------------------
----------------------------
----S---------<>---SSS-----S
--------------[]------------
--------------[]------------
---------E----[]----------E-
XXXXXXXXXXXXXXXXXXXXXXXXXXXX