----------------------------
----------------------------
-------XX-------------------
-------XX-------------------
-------XX-------------------
-SSS-SXXXXXX----------SSSSSS
----------------------------
----------------------------
----------------------------
-----------------<>--S------
-----------------[]---------
-----------------[]---------
-----------------[]-------E-
XXXXXXXX---XXXXXXXXXXXXXXXXX