----------------------------
----------------------------
----------------------------
----------------------------
----------------------------
---------------------SSSSSSS
----------------------------
----------------------------
----------------------------
-----Q--------<>----S-------
----------------------------
<>------------[]------------
[X-E-E------E-[]------------
XXXXXXXXXXXXXXXXXXXXXXXXXXXX