----------------------------
----------------------------
----------------------------
----------------------------
----------------------------
----------------------------
----------------------------
----------------------------
----------------------------
-----QS-Q------<>---------X-
->-------------[]---X----XX-
<>-------------[]--X-----XX-
[]-E-E---------[]-EXX---XXXX
XXXXXXXXXXXXXXXXXXXXXXXXXXXX