----------------------------
----------------------------
----------------------------
----------------------------
----------------------------
----S----------------SSS----
----------------------------
----------------------------
----------------------------
-QS--------------<>---------
-----------------[]---------
-----------------[]----X----
------E--------E-[]----XX---
XXX---XX----XXXXXXXXXXXXXXXX