----------------------------
----------------------------
--------X-------------------
-------XXX------------------
-------XXX------------------
--------XXXX----------------
----------------------------
----------------------------
----------------------------
-----------------<>---------
-----------------[]---------
-----------------[]---------
---------------E-[]--------E
---------------X-X--------XX