----------------------------
----------------------------
----------------------------
----------------------------
----------------------------
----------------------------
----------------------------
----------------------------
----------------------------
----S-SQ------SS------SXX---
-----------------------X----
----------------------------
------------E---------------
XXXXXXXXXXXXXXXXXXXXXXXXXXXX