----------------------------
----------------------------
----------------------------
----------------------------
----------------------------
-----------------SS--SSSS---
----------------------------
----------------------------
----------------------------
-----------------<>---------
-----------------[]---------
-----------------[]---------
-------------E-E-[]----EE---
XXXXXXX-----XXXXXXXXXXXXXXXX