----------------------------
----------------------------
----------------------------
----------------------------
----------------------------
----------------------------
----------------------------
----------------------------
----------------------------
--------------------------XX
---------------------X---XXX
--------------------XX---XXX
----------------]--XXX---XXX
XXXXXXXXXXXXXXXXXXXXXXXXXXXX